5,5,5
3333333343333333333333333
2000020000400002000022242
2000020000200002000024242
2000020000400002000022242
2000020000400002000022242